1111111111111111111111111
1000000100010000000000001
1000000100010000001111111
1000000100010000001000001
1000000111110000001111111
1000000000000000000000001
1000000000000000000000001
1000000000000000000000001
1000000000000000000000001
1000000000011111111111111
1000000000010000000000001
1000000000010000000000001
1000000000010000000000001
1111110000010000000000001
1100000000010000000000001
1100000000010000000000001
1111000000000000000000001
1111111111111111111111111
